111111
1M00E1
10C011
100101
1P0011
111111