111111
1M01E1
10C101
100111
1P0001
111111