1111111111111111
100000000000C001
1111111110100C01
1000000C10000001
11C00011100010C1
10000E1P00000001
1111111111111111