111111111111111111111111111111
1C0100000001C00000000000010C01
100000000001110000000000010001
100011000000010000000000000001
100000000000000000011000000001
10000000M0000000000C1000000001
100000000000000111111100000001
100C11000000000100C10000000001
10001E000000C0010P000000000001
10000000000000010000000C001001
111111111111111111111111111111
