1111111111111111111111111
11C0000000111111010111111
1010000000011110000010111
1001000M0000110000C000011
10000000000C0000000000001
1000000CP00010C0000000001
100C000000000000000000001
10000C000010E000000000011
1000000011100000000110111
1000000111000000101111111
1000000110000000111111111
1111111111111111111111111
