11111111111111111111
10001111110111000011
11C0011110001000E001
1000011100C000C00001
1C000011100000001001
100P0001110000000001
100000111100C0001001
11000001100M00010C01
11100000000001111001
101100000C0000111101
10011000000001111111
11111111111111111111
