1111111111111111111111
1100000110010000110C01
10000000001000C0000001
1100P00C01110000000011
1110000001111000110001
1011000000111000100001
1010000000011000000C01
101010E00011000M000001
1110110000100000000011
10000110C0000C00000001
100000100000000001C111
1000000000000000101101
110C001000C00001111001
1111111111111111111111