111111111111
101000110001
10000P000C01
1C0000E00111
10101M0001C1
110C01000001
10C001100C01
110011101101
111111111111
