111111111
100C10101
1001100C1
1000000M1
10P010E01
1100100C1
111111111