1111111111111111111111111111
1111000001111111111000000001
1110000000101111111000000C11
111000000100011111000C000001
110M000000C000111000P0000001
1000000C00000001110000000C01
1100000000000000100000000001
1000000000000110001100000001
100C000001001110011111000001
10000000000111101111111E0001
1000001100011110011111110001
1000011000001110001111111011
1100110000000100000111111111
1111111000001000000011111111
1111111111111111111111111111
