1111111111111111111111111111111
1111111110001111111100000001011
1C01111100C00111111110C0001C001
110011100M000011111111000000001
1000011000000111011111001000001
1000000000000010001101011000001
1P0000000000C000000000011100C01
1000100000000000000C00011110001
1000110E00000000000000001111011
100001100010000C000000011111111
10C0001101110001000000111111111
1111111111111111111111111111111
