11111111111111111111111111111111
11100011110000011111000000000001
11000001100000001110000000000001
100000000100000111110000000C0011
1100000000100001111110E000000111
111000000000000001111000C0001111
111000000000M00P0011101100001111
11000100000000000001001100101111
10000000001000000000011101101111
10000C00011010000000011100001111
1000C000111011100000001100011111
11000100111001110000000000001111
11101100011000111000000000000111
11111000000000011100011000001111
11110000000000001110111100011111
11111111111111111111111111111111
