1111111
1000001
1M00001
1000001
1000E01
1000001
1000001
1000C01
1000001
1000P01
1000001
1111111
